╔═══════════════════════════════════╗
║           ╔══════════╗            ║
║           ║          ║  ╔══╗      ║
║     ╔═══╗ ║          ║  ║  ║      ║
║     ║   ║ ╚══════════╝  ║  ║      ║
║     ║   ║               ║  ║      ║
║     ║   ║        ╔════╗ ║  ║      ║
║     ║   ║   ╔══╗ ║    ║ ║  ║      ║
║     ║   ║   ║  ║ ║    ║ ║  ║      ║
║     ║   ║   ╚══╝ ╚════╝ ║  ║      ║
║     ║   ║               ║  ║      ║
║     ╚═══╝  ════════════ ╚══╝      ║
║                                   ║
║                                   ║
║                                   ║
║                                   ║
╚═══════════════════════════════════╝
