+-----------------------------------------------------------------------+
|                                                                       |
|                                                                       |
|                                                                       |
|      +---------+      +-+   +----+                                    |
|      |         |      | |   |    |      +-------------------+         |
|      |         |      | |   |    |      |                   |         |
|      |         |      | |   |    |      |                   |         |
|      |         |      | |   |    |      |                   |         |
|      |         |      | |   |    |      |                   |         |
|      +---------+      | |   +----+      |                   |         |
|                       | |               |                   |         |
|      +-----------+    | |               |                   |         |
|      |           |    | |               |                   |         |
|      |           |    | |               |                   |         |
|      +-----------+    +-+               +-------------------+         |
|                            +--+                                       |
|          +----------+      |  |                                       |
|          |          |      |  |                +----+                 |
|          |          |      +--+                |    |                 |
|          |          |                  +---+   |    |   +----+        |
|          |          |      +------+    |   |   |    |   |    |        |
|          |          |      |      |    |   |   |    |   |    |        |
|          |          |      |      |    |   |   |    |   |    |        |
|          +----------+      +------+    +---+   +----+   +----+        |
|                                                                       |
+-----------------------------------------------------------------------+