+-------------------------------------------------------------------------------------------------------+
|                                                                                                       |
|                                                                                                       |
|                                                            +------------------+                       |
|                                +--------+                  |                  |                       |
|  +----+                        |        |                  |                  |                       |
|  |    |                        |        |                  +------------------+                       |
|  |    |     +----------+       |        |                                               +----+        |
|  |    |     |          |       +--------+     +--------------------------------+        |    |        |
|  |    |     |          |                      |                                |        |    |        |
|  |    |     |          |                      |                                |        +----+        |
|  +----+     |          |                      |                                |                      |
|             |          |                      |                                |                      |
|             |          |       +-----+        |                                |                      |
|             |          |       |     |        |                                |                      |
|             +----------+       |     |        |                                |          +-----+     |
|                                +-----+        |                                |          |     |     |
|                                               |                                |          |     |     |
|     +----+                                    +--------------------------------+          |     |     |
|     |    |    +------+    +-----+                                                         |     |     |
|     +----+    |      |    |     |            +-------+                                    |     |     |
|               |      |    +-----+            |       |                         +----+     |     |     |
|               |      |                       +-------+             +----+      |    |     +-----+     |
|               +------+                                             |    |      +----+                 |
|     +---+                                                          +----+                             |
|     |   |     +------+        +------------------------+                                              |
|     |   |     |      |        |                        |                 +----------+                 |
|     |   |     |      |        |                        |    +------+     |          |     +-----+     |
|     +---+     +------+        |                        |    |      |     |          |     |     |     |
|                               |                        |    |      |     |          |     |     |     |
|      +-----------+            |                        |    |      |     |          |     |     |     |
|      |           |            |                        |    |      |     |          |     |     |     |
|      |           |            |                        |    |      |     +----------+     |     |     |
|      |           |            |                        |    +------+                      +-----+     |
|      +-----------+            |                        |                                              |
|                               +------------------------+                                              |
|                                                                                                       |
+-------------------------------------------------------------------------------------------------------+