+----------------+
|                |
|           +--+ |
|   +---+   |  | |
|   |   |   +--+ |
|   +---+        |
|                |
+----------------+